NNWWWWWW
WWW....W
W...B..W
W....P.W
W......W
W......W
W..S...W
W......W
WWWWWWWW
