NNWWWWWW
WWW....W
W...B..W
W......W
W......W
W......W
W..S.P.W
W......W
WWWWWWWW
