N N W W W W W W
W W W . . . . W
W . . . BB . . W
W . . RB . . . W
W . P . . . . W
W . . . . RS . W
W . . BS . . . W
W . . . . . . W
W W W W W W W W
